##########
#..#####0#
#.######.#
#.######.#
#........#
##########
