##########
###L######
#.#,,,,,M#
#.#,,#,,,#
#........#
##,#,#,#D#
##L,,,M#0#
##########