############
#,,#M,O,,,,#
#,,#,L#,,,,#
#O,#O,#,,#,#
#,,#,,#,,,,#
#M,,,,DMM,O#
############
