##########
#,,,,,,,,#
#OOO,,,,,#
#,,,,,,,,#
#,,,MMM,,#
#,,,,,,,,#
#,,,,,,,0#
##########
