#############
#,,#M,O,,,,,#
#,,#,L#,,,,,#
#O,#O,#,,#,,#
#,,#,,#,,,,,#
#M,,,,DOMM,0#
#############
