##########
#,,,,,,,,#
#,,,,,,,,#
#,,,,,,,,#
#,,,,,M,,#
#,,,,,,,,#
#,,,,,,,0#
##########
