##############
#,,,,,,,,,,,,#
###,#,#,#,,,,#
#,,,,,OOO,,###
#,,,#M#,,#####
#,,,,M,,0#####
##############
