#####################
#.......#####,,,M,,0#
######..#####,,,,#,,#
###........##.#,,,O##
###...O,O#.##,,#,M,,#
###.,,,,.#.##,,M,#,O#
###.,,,,.#D##,,,,M,,#
###.MMM#.#D##O,#,,#.#
###.#,,#.#.##,,#O,#.#
###..,,#L#.##,,.....#
####.,.###..#####...#
####.,.####....O,,,M#
##..,,,,..#.#######M#
##..#M,#..#....O,,,M#
##L.,,,,.L#########.#
#####################
