######################
#,,,,,,,,,,,,,##.....#
#,##,,,,,,,##L##.....#
#,L#M,,,,,,#####.....#
#,#,,,###M,,,O##.....#
#,#,,,##L###,,####D###
#,##,,,,,,,#,,,,,,,,,#
#,,##,,,,,#,,,,,,,,,,#
#,,,##,,,#,,,,,,,,,,,#
#,,,,#MM#,,,,,,,,M,,,#
#,,,,,,,,,,,,,,,,,,,,#
######################
