##########
#.##..##0#
#.##..##.#
#.##..##.#
#........#
##########
