##########
#.#L#L####
#.#.#D##0#
#......D.#
##########
