############################
#.#####.D.................L#
#.#####.####################
#.#####...................L#
#.##############D###########
#.##############.###L#######
#.##############.###D#######
#.##......................L#
#.##.###############.#######
#.##.###############..L#####
#.##.###############.#######
#.##.......................#
#.#####D##################.#
#.#####D##################.#
#.#####L##################.#
#.##################.......#
#.##################.#####.#
#.##################.#####.#
#.##################.#####.#
#............D.............#
############.#######D#######
#L######..........##.#######
#.######.###########.#######
#......D......L#####......0#
############################
