#############################################################################################################
#.#####..................................######................................#################..........0##
#.#####.################.######.###############...........#################.##..........#####....############
#.#####...................#####.######.####################################.###.........#.....###############
#.##############.#######..............###...................................##############..................#
#.##############.###.##########.######.#######################...........########..........###############.##
#.##############.###.##########.######...................#########...........#############.###########.....##
#.##.........................###.##########.###############.#########.##################...########....######
#.##.###############.##########................................#########....................########.########
#.##.###############.##############################...........#########..................###########.########
#.##.###############.##########################........#####.#############.##.##########....########.########
#.##............................................#############################.#############.########.########
#.#####.##################............................................................#############........##
#.#####.##################.#########.#######.##########################.###.##############################.##
#.#####.##################.#########.#######.######################.........###.##########################.##
#.##################............#########.#######.##############....########..........############.........##
#.##################.#####.#########.#######.....................####################.############.....######
#.##################.#####.#########.#################.......................########..############.#########
#.##################.#####.####.............###########################....................########......####
#......................................#####.##########..............#####################.########.#########
############.#######.#####.####.############.##########################.........##........................###
#.######..........#######.#####.####.############.#######################........#.#################......###
#.######.###########.######.....................................############....................####.########
#..............#######.........########################..........................#########...............####
#############################################################################################################
