##########
#.#L######
#.#.####0#
#......D.#
###.######
###L######
##########
