##########
#..#....##
#..#D##.0#
#.....L###
#.###D#.L#
#L#L.....#
##########
