##########
#........#
#........#
#........#
#........#
#.......0#
##########
