##########
#........#
#......#.#
#......#.#
#......#.#
#......#0#
##########
