##########
#,,,,,,,,#
#,,,,,,#,#
#,,,,,,#,#
#,,,,,,#,#
#,,,,,,#0#
##########
